NO ./texture/hitoshi.xpm
SO ./texture/noroyama.xpm
WE ./texture/taro.xpm
EA ./texture/watari.xpm
F 20,20,24
C 140,170,210
111111111111111111111111111111
1N0000000000000000000000000001
101111111111111111111111110101
100000000000000000000000010001
111111111111111111111111111111
