NO ./texture/hitoshi.xpm
SO ./texture/noroyama.xpm
WE ./texture/taro.xpm
EA ./texture/watari.xpm
F 28,24,18
C 150,180,180
    1111111111
    1N00000001
1111110111111
1000000000001
1011111111101
1000000000001
1111111111111
