NO ./texture/hitoshi.xpm
SO ./texture/noroyama.xpm
WE ./texture/taro.xpm
EA ./texture/watari.xpm
F 22,26,32
C 200,190,160
1111111111111111
1N00001000000001
1011100110111111
1000100000100001
1110111110101101
1000001000100001
1011111011110101
1000000000000001
1111111111111111
