NO ./texture/hitoshi.xpm
SO ./texture/noroyama.xpm
WE ./texture/taro.xpm
EA ./texture/watari.xpm
F 35,25,20
C 170,170,180
1111111
1N00001
1110101
1000101
1011101
1010001
1010111
1010001
1011101
1000001
1111111
