NO ./texture/hitoshi.xpm
SO ./texture/noroyama.xpm
WE ./texture/taro.xpm
EA ./texture/watari.xpm
F 30,30,999
C 180,180,220
1111
1N01
1001
1111
