NO ./texture/hitoshi.xpm
SO ./texture/noroyama.xpm
WE ./texture/taro.xpm
EA ./texture/watari.xpm
F 30,30,30
1111
1N01
1001
1111
